+---++---++---++---+
|                  |
+   ++---++   ++   +
+   ++---++   ++   +
|   ||        ||   |
+   ++---++---++   +
+   ++---++---++   +
|        ||        |
+   ++---++   ++   +
+   ++---++   ++   +
|   ||        ||   |
+   ++---++---++   +
