+---+---+---+---+
|               |
+   +---+   +   +
|   |       |   |
+   +---+---+   +
|       |       |
+   +---+   +   +
|   |       |   |
+   +---+---+   +
